Name	title	coding
t3_qrnmhc	"starbucks w/ seating?"	f
t3_qrb441	"Can't stop crying every day"	o
t3_qrb0la	"FREN 231 - Linguistique français as a non-native speaker?"	c
t3_qr9i24	"How likely are class locations to change?"	c
t3_qr8mpn	"I have seen a white squirrel outside of Mcgill"	o
t3_qr62ge	"Leetcode club?"	o
t3_qr4ttx	"Found Cloudberry's nemesis, does he have a name?"	o
t3_qr3qcc	"COMP 251 MIDTERM"	c
t3_qqzdrh	"Class rank for MSc. application?"	c
t3_qqzrhw	"Study Permit expiry date changed?"	o
t3_qqwdur	"Working at a residence dining hall?"	r
t3_qquzwa	"covid testing at hotel dieu: questions"	o
t3_qqrn2l	"Feeling bummed knowing I don’t got what it takes to make it to medicine"	c
t3_qqonfn	"Does Prof. Daniel Cere award grades above 85% / is common or possible to get 90-95% ?"	c
t3_qqlli3	"Anyone else gonna be an old ass undergrad?"	o
t3_qqf5wt	"Get Paid to do Self-Guided Research! McGill Journal of Human Behavior Research Fellowship"	o
t3_qqbjfk	"Comp302 Assignment"	c
t3_qqd74r	"In need of a study buddy"	c
t3_qqcxo7	"How to review for Comp 250/273?"	c
t3_qq9hxp	"Is there a difference between PSYC 395 and 494?"	c
t3_qq7k1p	"I’ve been here for 5 damn years and I finally got to see cloudberry!! She is perfect."	o
t3_qq6ao9	"OSD Exam Procedure"	o
t3_qq5p9m	"French courses at McGill FRSL vs CEFN"	c
t3_qq0d9v	"Should I wait until the status of the medical exam is updated to arrive?"	o
t3_qpo74y	"Grading at McGill"	c
t3_qpo84a	"How many days ahead do you typically start studying for a midterm?"	c
t3_qpkl4v	"what is this about? seems sus"	o
t3_qpknpx	"PHIL 434 Midterm"	c
t3_qphe5x	"Starting a band"	o
t3_qphbd3	"DONE WITH HEALTH SERVICES"	o
t3_qph27r	"Struggling with Language at Work"	o
t3_qpfm5z	"Flags lowered in memory of deceased students: Cause of death?"	o
t3_qpeplw	"In-person final exams set in stone?"	c
t3_qpdtsm	"International student insurance coverage for consultation with a doctor outside McGill"	o
t3_qpd7vg	"Is there free COVID testing for McGill students?"	o
t3_qp87j2	"On-campus study spots with nice outside view ?"	o
t3_qp5rs9	"COMP 252"	c
t3_qp5hbh	"anyone took mgcr 382 with Nicholas Matziorinis?"	c
t3_qp5adh	"Going less than full time as an intl student for personal reasons?"	c
t3_qp536l	"BIOC 311. oh my god"	c
t3_qp2flr	"Was Just Informed that I am not Going to Make it in the Workforce"	o
t3_qp0a8e	"Anyone willing to share psyc 213 notes?"	c
t3_qou8zc	"fall 2021 SSMU referendum starts tomorrow!"	o
t3_qos56x	"Quick SOCI235 Questions"	c
t3_qorssr	"Is it cold on campus today?"	o
t3_qodyxq	"Wellness hub replacement?"	o
t3_qoa51e	"Cloudberry and a friend"	o
t3_qo9l6v	"Is Submitting a Final Exam Paper to a Journal Problematic?"	o
t3_qo77a3	"CodeJam Updates!"	o
t3_qo1vab	"Winter 2022 Exchange Reinstatement: Australia"	c